+--+--+--+--+--+--+--+--+--+--+
|p |              |     |     |
+  +  +  +--+--+  +  +--+  +  +
|  |  |     |        |     |  |
+  +  +--+  +--+  +--+  +--+  +
|     |  |     |  |     |     |
+  +--+  +--+  +--+  +--+  +  +
|           |  |     |     |  |
+--+--+--+--+  +  +--+  +--+  +
|        |     |  |  |  |     |
+  +--+  +  +--+  +  +  +--+  +
|  |  |  |  |     |  |     |  |
+  +  +  +  +  +--+  +--+  +  +
|     |  |  |           |  |  |
+--+  +  +  +  +--+--+--+  +  +
|  |  |  |     |           |  |
+  +  +  +--+--+  +--+--+--+  +
|  |  |     |     |  |     |  |
+  +  +--+--+  +--+  +  +  +  +
|              |        |    g|
+--+--+--+--+--+--+--+--+--+--+

