+--+--+--+--+--+--+--+--+--+--+
|p                      |     |
+  +--+  +--+--+  +--+--+  +  +
|  |     |        |        |  |
+--+  +  +--+--+  +  +--+--+  +
|     |  |     |  |  |        |
+  +  +--+  +  +--+  +  +--+--+
|  |  |     |     |  |        |
+  +--+  +  +--+  +  +--+--+  +
|  |     |  |  |  |     |  |  |
+  +  +--+--+  +  +--+  +  +  +
|  |     |     |     |  |     |
+  +--+  +  +--+--+  +  +  +--+
|     |  |  |     |     |     |
+  +  +  +  +  +--+--+--+--+  +
|  |  |     |  |     |        |
+  +--+--+--+  +  +  +  +--+--+
|     |     |     |  |        |
+  +  +  +  +  +--+  +--+--+  +
|  |     |        |          g|
+--+--+--+--+--+--+--+--+--+--+

