+--+--+--+--+--+--+--+--+--+--+
|p |              |           |
+  +  +  +--+--+  +  +--+--+  +
|     |  |     |     |     |  |
+  +--+  +  +--+--+--+--+  +  +
|     |  |  |              |  |
+--+--+  +  +  +--+  +--+--+  +
|        |     |  |        |  |
+  +--+--+--+  +  +--+--+  +  +
|           |     |     |     |
+--+--+--+  +--+  +--+  +--+--+
|        |  |  |        |     |
+  +--+  +  +  +--+--+  +  +  +
|  |  |  |  |        |     |  |
+--+  +  +  +  +  +--+--+--+  +
|        |  |  |  |        |  |
+  +--+--+  +  +  +  +  +  +  +
|           |  |     |  |  |  |
+--+--+--+--+  +--+--+  +--+  +
|                    |       g|
+--+--+--+--+--+--+--+--+--+--+

