+--+--+--+--+--+--+--+--+--+--+
|p             |              |
+  +--+--+--+  +  +--+--+  +--+
|           |  |        |     |
+  +--+--+  +  +--+--+--+  +  +
|  |  |     |           |  |  |
+  +  +  +--+--+--+--+  +--+  +
|  |  |  |           |     |  |
+  +  +  +--+--+  +  +--+  +  +
|     |        |  |     |     |
+--+  +--+--+  +--+  +--+--+  +
|        |     |     |     |  |
+--+--+--+  +--+  +--+  +  +  +
|           |  |        |     |
+  +--+--+--+  +  +--+--+--+--+
|        |     |  |     |     |
+--+--+  +  +  +  +  +  +  +  +
|        |  |  |  |  |     |  |
+--+--+--+  +  +  +--+--+--+  +
|           |                g|
+--+--+--+--+--+--+--+--+--+--+

