+--+--+--+--+--+--+--+--+--+--+
|p    |                    |  |
+  +  +--+--+--+  +--+--+  +  +
|  |  |        |     |        |
+  +  +  +--+  +--+  +--+--+  +
|  |     |           |     |  |
+  +--+  +--+--+--+--+  +--+  +
|  |  |  |              |  |  |
+  +  +  +  +--+--+--+--+  +  +
|  |     |  |              |  |
+  +--+  +  +--+  +  +--+--+  +
|     |  |     |  |        |  |
+  +  +--+--+  +  +--+--+  +  +
|  |        |  |  |     |     |
+  +--+  +--+  +  +  +  +--+--+
|     |  |     |     |        |
+  +--+  +  +--+--+--+--+--+  +
|  |     |  |              |  |
+  +  +--+  +  +--+--+  +--+  +
|  |        |        |       g|
+--+--+--+--+--+--+--+--+--+--+

