+--+--+--+--+--+--+--+--+--+--+
|p    |                       |
+  +  +  +--+--+--+  +--+--+  +
|  |     |           |        |
+  +--+--+  +--+--+--+--+--+--+
|     |  |        |     |     |
+--+  +  +--+--+  +  +  +  +  +
|  |  |     |  |     |     |  |
+  +  +  +  +  +--+--+--+--+  +
|  |     |     |              |
+  +--+  +--+--+  +--+--+--+--+
|        |     |        |     |
+  +--+--+  +--+--+  +  +  +  +
|        |  |     |  |     |  |
+--+--+  +  +  +  +--+--+--+  +
|        |  |  |        |     |
+  +--+--+  +  +--+--+  +  +  +
|  |        |     |  |  |  |  |
+  +  +--+--+--+  +  +  +  +  +
|  |              |        | g|
+--+--+--+--+--+--+--+--+--+--+

