+--+--+--+--+--+--+--+--+--+--+
|p    |                       |
+  +--+  +--+--+--+  +  +--+--+
|           |        |  |     |
+  +--+--+--+  +--+  +--+  +  +
|     |        |     |     |  |
+  +--+  +--+--+--+  +  +--+  +
|  |     |        |  |  |     |
+--+  +  +  +--+  +--+  +  +--+
|     |  |  |           |  |  |
+  +--+  +  +--+--+--+--+  +  +
|  |     |  |  |        |  |  |
+  +--+--+  +  +  +--+  +  +  +
|  |        |  |     |     |  |
+  +  +--+--+  +--+  +--+--+  +
|  |  |        |     |        |
+  +  +  +--+--+  +--+--+--+  +
|  |     |        |        |  |
+  +--+--+  +--+--+--+  +  +  +
|                       |    g|
+--+--+--+--+--+--+--+--+--+--+

