+--+--+--+--+--+--+--+--+--+--+
|p |     |        |  |        |
+  +  +--+--+  +  +  +  +  +  +
|  |           |  |     |  |  |
+  +--+--+--+--+  +--+--+  +  +
|           |  |  |        |  |
+  +--+--+  +  +  +  +--+--+  +
|  |  |        |  |  |        |
+  +  +  +--+--+  +  +--+  +--+
|  |     |        |     |     |
+  +  +--+  +--+--+  +  +--+  +
|  |  |     |        |  |     |
+  +--+  +--+--+--+--+  +--+--+
|        |           |        |
+  +--+--+--+  +--+  +--+--+  +
|  |        |  |     |     |  |
+  +  +--+  +  +  +--+  +  +  +
|     |  |  |  |     |  |  |  |
+--+--+  +  +  +--+  +  +  +  +
|              |        |    g|
+--+--+--+--+--+--+--+--+--+--+

