+--+--+--+--+--+--+--+--+--+--+
|p             |        |     |
+  +--+--+--+  +--+  +--+  +  +
|           |     |  |     |  |
+--+--+--+--+--+  +  +  +--+  +
|        |     |  |  |     |  |
+  +  +  +  +--+  +  +  +--+  +
|  |  |  |  |     |     |     |
+  +  +  +  +  +--+  +--+  +  +
|  |  |     |  |        |  |  |
+  +  +--+--+  +--+--+--+  +  +
|  |        |           |  |  |
+  +--+--+  +--+--+--+  +  +  +
|  |     |           |     |  |
+  +  +--+--+--+  +  +--+--+  +
|  |           |  |  |        |
+  +--+--+--+  +  +--+  +--+--+
|           |  |        |     |
+--+--+--+  +  +--+--+--+  +  +
|                          | g|
+--+--+--+--+--+--+--+--+--+--+

